R 1920 1080
NO ./path_to_the_north_texture
SO ./path_to_the_south_texture
WE ./path_to_the_west_texture
EA ./path_to_the_east_texture

S ./path_to_the_sprite_texture
F 220,100,0
C 225,30,0

1111111111111111111111111100000000011000000000000110110000011100000020000011001000000000000000000001111111111011000001110000000000001100000000011000001110111111111111111101111111110111000000100011111011111111101110101001000111000000110101011100000010001100020000000000011000000100011000000000000000110101001000111000001110101011111011110N011111110111 1110101 10111101000111111111 1111111 111111111111
