R 1920 1080
NO test.cub
SO test.cub
WE test.cub
EA test.cub

S test.cub
F 220,100,0
C 225,30,44

11111111111111111111111111
10000000000E000000000000111111
111000000000000000000000011
1000000000000000000000001
100000000000000W00000000001
1000000000000000000000000111
1111111111111111111111111111
